# 구현해야 할 목록
# member section
#meLogin=com.shopping.controller.member.MemberLoginController
#meLogout=com.shopping.controller.member.MemberLogoutController
meInsert=com.livre.controller.member.MemberInsertController
meEmailCheck=com.livre.controller.member.MeEmailCheckController
joinMemberShip=com.livre.controller.member.joinMemberShipController
collectPreference=com.livre.controller.member.CollectPreferenceController
celebrate=com.livre.controller.member.CelebrateController
selectGender=com.livre.controller.member.SelectGenderController
createNickname=com.livre.controller.member.CreateNicknameController
finalCheck=com.livre.controller.member.FinalCheckController
#meUpdate=com.livre.controller.member.MemberUpdateController
#meList=com.shopping.controller.member.MemberListController
meDelete=com.livre.controller.member.MemberDeleteController
#meDetail=com.shopping.controller.member.MemberDetailController
# book section
bookList=com.livre.controller.book.BookListController
bookDetail=com.livre.controller.book.BookDetailController
reviewInfo=com.livre.controller.book.ReviewInfoController
my-review=com.livre.controller.book.MyReviewController
reviewDel=com.livre.controller.book.DeleteReviewController
reviewSearch=com.livre.controller.book.MyReviewSearchController
reviewSearched=com.livre.controller.book.MyReviewSearchedController
reviewDetail=com.livre.controller.book.MyReviewDetailController
reviewUpdate=com.livre.controller.book.MyReviewUpdateController
reviewInsert=com.livre.controller.book.InsertReviewController
# member section
login=com.livre.controller.member.MemberLoginController
logout=com.livre.controller.member.MemberLogoutController
findPassword=com.livre.controller.member.FindPasswordController
tempPassword=com.livre.controller.member.TempPasswordController
updatePassword=com.livre.controller.member.UpdatePasswordController
my-page=com.livre.controller.member.MyPageController
myFavoriteReview=com.livre.controller.member.MyFavoriteReviewController
#kakaoLogin=com.livre.controller.member.KakaoLoginController
ImgUpdate=com.livre.controller.member.ImgUpdateController
contactus=com.livre.controller.member.ContactUsController
# main section
main-page=com.livre.controller.book.MainPageController
#MyServletAjax=com.livre.controller.member.MyServletAjax